========================================================
| ==========      ============                        =|
|  ========        ============                      ==|
|   ======          ============                    ===|
|    ====            ============                  ====|
|     ==              ============                =====|
|                      ============               =====|
|                       ============               ====|
|                        ============               ===|
|                         ============               ==|
|=                         ============               =|
|==                         ============               |
|===                         ==========                |
|===                          ========                 |
|==                            ======                  |
|=         ==                   ====                   |
|         ====                   ==                    |
|        ======                                        |
|       ========                             ==        |
|      ==========                           ====       |
|     ============                         ======      |
|    ==============                       ========     |
|     ============                       ==========    |
========================================================