========================================================
|                                ==                    |
|                                ==                    |
|                                ==                    |
|                                ==                    |
|                                ==                    |
|                                ==                    |
|                                ==                    |
|                                ==                    |
|                          ==============              |
|                                                      |
|                                                      |
|                                                      |
|                                                      |
|             ==============                           |
|                   ==                                 |
|                   ==                                 |
|                   ==                                 |
|                   ==                                 |
|                   ==                                 |
|                   ==                                 |
|                   ==                                 |
|                   ==                                 |
========================================================