============================================================
|                                  ==                      |
|                                  ==                      |
|                                  ==                      |
|                                  ==                      |
|                                  ==                      |
|                                  ==                      |
|                                 ====                     |
|                                ======                    |
|                               ========                   |
|                              ==========                  |
|                             ============                 |
|                              ==========                  |
|                     ==        ========                   |
|                    ====        ======                    |
|                   ======        ====                     |
|                  ========        ==                      |
|                 ==========                               |
|                ============                              |
|                 ==========                               |
|                  ========                                |
|                   ======                                 |
|                    ====                                  |
|                     ==                                   |
|                     ==                                   |
|                     ==                                   |
|                     ==                                   |
|                     ==                                   |
|                     ==                                   |
============================================================