============================================================
|  ============================                           =|
|   ============    ============                         ==|
|    ==========      ============                       ===|
|     ========        ============                     ====|
|      ======          ============                   =====|
|       ====            ============                 ======|
|        ==              ============                ======|
|                         ============                =====|
|                          ============                ====|
|                           ============                ===|
|=                           ============                ==|
|==                           ============                =|
|===                           ============                |
|===                            ==========                 |
|==                              ========                  |
|=                                ======                   |
|             ==                   ====                    |
|            ====                   ==                     |
|           ======                                         |
|          ========                              ==        |
|         ==========                            ====       |
|        ============                          ======      |
|       ==============                        ========     |
|        ============                        ==========    |
|         ==========                        ============   |
|          ========                        ==============  |
|           ======                        ================ |
|            ====                        ==================|
============================================================