============================================================
|=====               ====                    ===           |
|====                 ====                    ===          |
|===                   ====                    ===         |
|==                     ====                    ===        |
|=                     =======                  ===        |
|                     =========                ===         |
|                    ====   ====              ===          |
|                   ====     ====            ===           |
|=                 ====       ====          ===            |
|==               ====        ====         ===            =|
|===             ====        ====         ===            ==|
|====                       ====         ====           ===|
|=====                     ====         ======           ==|
|=====         ====       ====         ========           =|
|====         ====       ====         ====  ====           |
|===         ====       ====         ====    ====          |
|==         ====       ====         ====      ====         |
|=         ====       ====         ====        ====        |
|         ====        ====         ====        ====        |
|        ====          ====        ====        ====        |
|       ====            ====        ===        ===         |
|       ====            ====                               |
|=       ====          ====                                |
|==       ====        ====                ==               |
|===       ====                          ====             =|
|====       ====                        ======           ==|
|=====       ==========                ========         ===|
|======       ========                ==========       ====|
============================================================